Name: Rocky Rocamora
Address: 21 Fidela Soriano St. Hulong duhat Malabon City

---- MY FAVORITES ----
Food: Carbonara
Number: 09222059559
Colour: Blue
Flower: None
Drink: Cucumber Lemon Juice
Movie: None
TV Series: None
Animal: Cat
Celebrity: Cristiano Ronaldo
Hobby: Lifting Weights, Playing Mobile Legends, Walking
Solo Artist: None
Band: Westlife
Current Song: None
Sport: Football
Anime: Avatar the last airbender and Avatar
Game: Mobile Legends
Quote:

---- WHAT'S THE FIRST... ----
thing you did after you woke up: Mag goodmorning sa kaniya
song on your favorite playlist: random english and tagalog songs.
big chievement: Get this job.
thing you ate today: Spaghetti
first risk I ever took:

---- WHAT'S THE LAST... ----
book that you read:
movie I cried at:
thing you do before falling asleep: Mag cellphone


